>width 9
>height 9
>name Name
>tileset tileset.png
>layer
20,21,21,21,21,21,01,21,22
30,12,12,12,12,12,12,12,32
30,12,12,12,12,12,12,12,32
30,12,12,12,12,12,12,12,32
30,12,12,12,12,12,12,12,32
30,12,12,12,12,12,12,12,32
30,12,12,12,12,12,12,12,32
30,12,12,12,12,12,12,12,32
40,21,21,21,21,21,21,21,42